-35
13
-7
9
0000000000000000000000000000000000000000000000000
0000000000000000000001111111111111111111111111110
1111111111111110000001000000110000000000000000010
1000000001000010000001000111110000000000000000010
1000000100001010000001000011110000100000000000010
1000000000001011111111000000000000000100110100010
1000000000000000000010000000000010000000100100010
1000000000000010000000000000000000000000000000010
1000000000000000000000000000000000010000000000010
1000000010000000000000000000000000000000000000010
1000000010000000000000100000000000000000000100010
1000000010000100000000100000000010000000000000010
1000000000000011111111000001000000000000000000010
1000000000100010000001000000000000010000000000010
1000000000000010000001000000000000000000000000010
1111111111111110000001000000000000000000000000010
0000000000000000000001111111111111111111111111110
